draft	draft-recommendation-&mdash;-date:-01-jan-1901
abstract	abstract
status	status
configUI	configUI
updatesUI	updatesUI
updatesEnabled	updatesEnabled
updatesStatus	updatesStatus
stability0	stability-0
stability	stability
contents	contents
introduction	introduction
background	background
scope	scope
history0	history-0
relationships	relationships-to-other-specifications
relationship	relationship-to-html-4.01-and-dom2-html
relationship0	relationship-to-xhtml-1.x
relationship1	relationship-to-xhtml2-and-xforms
relationship2	relationship-to-xul,-flash,-silverlight,-and-other-proprietary-ui-languages
html-vs	html-vs-xhtml
structure	structure-of-this-specification
how-to	how-to-read-this-specification
typographic	typographic-conventions
this	x-this
this0	x-that
example	
infrastructure	infrastructure
terminology	terminology
content0	content-attributes
dom-attributes	dom-attributes
pause	pause
xml	xml
html-namespace	html-namespace
elements2	elements-in-the-html-namespace
html-elements	html-elements
xml-compatible	xml-compatible
dom-trees	dom-trees
root-element	root-element
inserted	insert-an-element-into-a-document
tree-order	tree-order
ignored	ignore
text-node	text-node
scripting0	scripting-0
live	live
plugins	plugins
plugin	plugin
character	character-encodings
ascii-compatible	ascii-compatible-character-encoding
conformance	conformance-requirements
interactive	interactive
non-interactive	non-interactive
non-scripted	non-scripted
conformance-checkers	conformance-checkers
data-mining	data-mining
editors	editors
hardwareLimitations	hardwareLimitations
xhtml5	xhtml5
html5	html5
authors-using-xhtml	authors-using-xhtml
authors-using-html	authors-using-html
entity-references	entity-references
dependencies	dependencies
mq	mq
features	features-defined-in-other-specifications
textcontent	textcontent
domtimestamp	domtimestamp
activation0	activation-behavior
alternate-style-sheets	alternate-style-sheets
common	common-conformance-requirements-for-apis-exposed-to-javascript
case-sensitivity	case-sensitivity
case-sensitive	case-sensitive
ascii	ascii-case-insensitive
compatibility	compatibility-caseless
converting	converted-to-uppercase
converting0	converted-to-lowercase
common0	common-microsyntaxes
common1	common-parser-idioms
space	space-character
whitespace	white_space
collect	collect-a-sequence-of-characters
skip-whitespace	skip-whitespace
skip-	skip-white_space-characters
boolean	boolean-attributes
boolean0	boolean-attribute
numbers	numbers
unsigned	unsigned-integers
valid	valid-non-negative-integer
rules	rules-for-parsing-non-negative-integers
signed	signed-integers
valid0	valid-integer
rules0	rules-for-parsing-integers
real-numbers	real-numbers
valid1	valid-floating-point-number
rules1	rules-for-parsing-floating-point-number-values
ratios	ratios
valid2	valid-denominator-punctuation-character
a-value	values-associated-with-denominator-punctuation-characters
steps	steps-for-finding-one-or-two-numbers-of-a-ratio-in-a-string
find-a	find-a-number
percentages-and-dimensions	percentages-and-dimensions
valid3	valid-positive-non-zero-integers
rules2	rules-for-parsing-dimension-values
lists	lists-of-integers
valid4	valid-list-of-integers
rules3	rules-for-parsing-a-list-of-integers
dates	dates-and-times
number0	number-of-days-in-month-month-of-year-year
specific	specific-moments-in-time
valid5	valid-datetime
refsGREGORIAN	refsGREGORIAN
datetime-parser	datetime-parser
vaguer	vaguer-moments-in-time
date-or	date-or-time-string
date-or0	date-or-time-string-in-content
date-or1	date-or-time-string-in-attributes
utc-dates	utc-dates-and-times
utc-date	concept-datetime
valid6	valid-utc-date-and-time-string
parse0	parse-a-utc-date-and-time-string
local	local-dates-and-times
local1	concept-datetime-local
valid7	valid-local-date-and-time-string
parse1	parse-a-local-date-and-time-string
dates0	dates
date	concept-date
valid8	valid-date-string
parse2	parse-a-date-string
months	months
month0	concept-month
valid9	valid-month-string
parse3	parse-a-month-string
weeks	weeks
week	concept-week
valid10	valid-week-string
parse4	parse-a-week-string
times	times
time	concept-time
valid11	valid-time-string
parse5	parse-a-time-string
time-offsets	time-offsets
valid12	valid-time-offset
rules4	rules-for-parsing-time-offsets
time-offset	time-offset-serialization-rules
space-separated	space-separated-tokens
set-of	set-of-space-separated-tokens
unordered	unordered-set-of-unique-space-separated-tokens
ordered	ordered-set-of-unique-space-separated-tokens
split	split-a-string-on-spaces
remove	remove-a-token-from-a-string
comma-separated	comma-separated-tokens
set-of0	set-of-comma-separated-tokens
split0	split-a-string-on-commas
keywords	keywords-and-enumerated-attributes
enumerated	enumerated-attribute
syntax-references	syntax-references
valid13	valid-hash-name-reference
rules5	rules-for-parsing-a-hash-name-reference
urls	urls
terminology0	terminology-0
url	url
urldoc	urldoc
valid14	valid-url
parsing0	parsing-urls
parse6	parse-a-url
ltschemegt	url-scheme
lthostgt	url-host
ltportgt	url-port
lthostportgt	url-hostport
ltpathgt	url-path
ltquerygt	url-query
ltfragmentgt	url-fragment
resolving	resolving-urls
base-	base-url
document0	document-base-url
resolve	resolve-a-url
absolute	absolute-url
dynamic	dynamic-changes-to-base-urls
affected	affected-by-a-base-url-change
interfaces	interfaces-for-url-manipulation
url-decomposition	url-decomposition-attributes
input	concept-uda-input
common6	concept-uda-setter
protocol	dom-uda-protocol
host	dom-uda-host
hostname	dom-uda-hostname
port	dom-uda-port
pathname	dom-uda-pathname
search	dom-uda-search
hash	dom-uda-hash
fetching	fetching-resources
fetch	fetch
aboutblank	about:blank
content-type-sniffing	content-type-sniffing
content-type	content-type
content-type5	content-type-0
algorithm	algorithm-for-extracting-an-encoding-from-a-content-type
content-type0	content-type-sniffing:-web-pages
sniffed	content-type-sniffing-0
content-type1	content-type-sniffing:-text-or-binary
content-type6	
binary	binary-data-bytes
content-type2	content-type-sniffing:-unknown-type
content-type7	
content-type3	content-type-sniffing:-image
content-type8	
content-type4	content-type-sniffing:-feed-or-html
content-type9	
common2	common-dom-interfaces
reflecting	reflecting-content-attributes-in-dom-attributes
reflect	reflect
limited	limited-to-only-known-values
limited0	limited-to-only-positive-non-zero-numbers
collections	collections
collections0	collections-0
represents	represented-by-the-collection
htmlcollection	htmlcollection
htmlcollection0	htmlcollection-0
length	dom-htmlcollection-length
itemindex	dom-htmlcollection-item
nameditem	dom-htmlcollection-nameditem
htmlformcontrolscollection	htmlformcontrolscollection
htmlformcontrolscollection0	htmlformcontrolscollection-0
length0	dom-htmlformcontrolscollection-length
itemindex0	dom-htmlformcontrolscollection-item
nameditem0	dom-htmlformcontrolscollection-nameditem
htmloptionscollection	htmloptionscollection
htmloptionscollection0	htmloptionscollection-0
length1	dom-htmloptionscollection-length
itemindex1	dom-htmloptionscollection-item
nameditem1	dom-htmloptionscollection-nameditem
domtokenlist	domtokenlist
domtokenlist0	domtokenlist-0
length2	dom-tokenlist-length
itemindex2	dom-tokenlist-item
hastoken	dom-tokenlist-has
addtoken	dom-tokenlist-add
remove0	dom-tokenlist-remove
toggle	dom-tokenlist-toggle
stringify	dom-tokenlist-tostring
domstringmap	domstringmap
domstringmap0	domstringmap-0
xxx1name	dom-stringmap-xxx1
xxx2name	dom-stringmap-xxx2
xxx3name	dom-stringmap-xxx3
dom-feature	dom-feature-strings
hasfeature	hasfeature
dom	dom
semantics-intro	semantics-intro
documents	documents
documents0	documents-in-the-dom
xml-documents	xml-documents
html-	html-documents
htmldocument	htmldocument
security	security
resource	resource-metadata-management
resource0	
url0	dom-document-url
referrer	dom-document-referrer
cookie0	dom-document-cookie
sandboxCookies	sandboxCookies
lastmodified	dom-document-lastmodified
no-quirks	no-quirks-mode
quirks	quirks-mode
limited1	limited-quirks-mode
compatmode	dom-document-compatmode
character4	document's-character-encoding
charset0	dom-document-charset
characterset	dom-document-characterset
defaultcharset	dom-document-defaultcharset
current	current-document-readiness
readystate	dom-document-readystate
dom-tree	dom-tree-accessors
dom-tree0	
the-html0	the-html-element-0
the-head0	the-head-element-0
the-title1	the-title-element-0
document.title	document.title
the-body1	the-body-element-1
body	dom-document-body
images0	dom-document-images
embeds	dom-document-embeds
plugins0	dom-document-plugins
links0	dom-document-links
forms0	dom-document-forms
anchors	dom-document-anchors
scripts	dom-document-scripts
getelementsbyname	dom-document-getelementsbyname
getelementsbyclassname	dom-document-getelementsbyclassname
getelementsbyclassname0	dom-getelementsbyclassname
elements	elements
semantics0	semantics-0
elements0	elements-in-the-dom
htmlelement	htmlelement
global	global-attributes
the-id	the-id-attribute
id	
id0	dom-id
the-title	the-title-attribute
title	
title0	dom-title
the-lang	the-lang-and-xml:lang-attributes
lang	
xmllang	
language	language
lang0	dom-lang
the-xmlbase	the-xml:base-attribute-(xml-only)
xmlbase	
the-dir	the-dir-attribute
dir	
the-directionality	the-directionality
dir0	dom-dir
dir1	dom-document-dir
classes	classes
class	
classname	dom-classname
classlist	dom-classlist
the-style	the-style-attribute
style	
style0	dom-style
embedding	embedding-custom-non-visible-data
embedding0	
custom	custom-data-attribute
data-	attr-data-*
dataset	dom-dataset
content	content-models
inter-element	inter-element-whitespace
preceded	preceded-or-followed
kinds	kinds-of-content
metadata	metadata-content
metadata0	metadata-content-0
flow-content	flow-content
flow-content0	flow-content-0
sectioning	sectioning-content
sectioning0	sectioning-content-0
heading	heading-content
heading0	heading-content-0
phrasing	phrasing-content
phrasing0	phrasing-content-0
embedded	embedded-content
embedded1	embedded-content-1
fallback	fallback-content
interactive0	interactive-content
interactive1	interactive-content-0
transparent	transparent-content-models
transparent0	transparent
semi-transparent	semi-transparent
paragraphs	paragraphs
paragraph	paragraph
apis-in	apis-in-html-documents
dynamic0	dynamic-markup-insertion
dynamic3	
document.write	dom-document-write
innerhtml	dom-innerhtml
outerhtml	dom-outerhtml
insertadjacenthtml	dom-insertadjacenthtml
document.writeln...	dom-document-writeln
controlling	controlling-the-input-stream
open	dom-document-open
script-created	script-created-parser
close0	dom-document-close
dynamic1	dynamic-markup-insertion-in-html
document.write...	dom-document-write-html
innerhtml0	dom-innerhtml-html
outerhtml0	dom-outerhtml-html
insertadjacenthtml0	dom-insertadjacenthtml-html
dynamic2	dynamic-markup-insertion-in-xml
innerhtml1	dom-innerhtml-xml
document.write0	dom-document-write-xml
insertadjacenthtml1	dom-insertadjacenthtml-xml
outerhtml1	dom-outerhtml-xml
semantics	semantics
the-root	the-root-element
the-html	the-html-element
html	
manifest	attr-html-manifest
document	document-metadata
the-head	the-head-element
head	
the-title0	the-title-element
title1	
the-base	the-base-element
base	
htmlbaseelement	htmlbaseelement
href	attr-base-href
target	attr-base-target
href0	dom-base-href
target0	dom-base-target
the-link	the-link-element
link	
htmllinkelement	htmllinkelement
href1	attr-link-href
rel	attr-link-rel
links1	external-resource-link
hyperlink1	hyperlink-link
media0	attr-link-media
default-media	default-media
hreflang	attr-link-hreflang
type	attr-link-type
concept-link-type-sniffing	concept-link-type-sniffing
title2	attr-link-title
href2	dom-link-href
rel0	dom-link-rel
media1	dom-link-media
hreflang0	dom-link-hreflang
type0	dom-link-type
sizes	dom-link-sizes
rellist	dom-link-rellist
disabled	dom-link-disabled
meta	meta
meta0	
htmlmetaelement	htmlmetaelement
charset1	attr-meta-charset
content1	attr-meta-content
name	attr-meta-name
name0	dom-meta-name
content2	dom-meta-content
httpequiv	dom-meta-httpequiv
standard	standard-metadata-names
application-name	meta-application-name
description	meta-description
generator	meta-generator
other	other-metadata-names
extensions	concept-meta-extensions
pragma	pragma-directives
http-equiv	attr-meta-http-equiv
content3	attr-meta-http-equiv-content-language
document-wide	document-wide-default-language
encoding	attr-meta-http-equiv-content-type
default	attr-meta-http-equiv-default-style
refresh	attr-meta-http-equiv-refresh
charset	charset
character5	character-encoding-declaration
the-style0	the-style-element
style1	
htmlstyleelement	htmlstyleelement
type1	attr-style-type
media2	attr-style-media
style-default-media	style-default-media
scoped	attr-style-scoped
title-on-style	title-on-style
title3	attr-style-title
media3	dom-style-media
type2	dom-style-type
scoped0	dom-style-scoped
disabled0	dom-style-disabled
styling	styling
styling0	
alternative	alternative-style-sheet-sets
disabled1	dom-linkstyle-disabled
scripting1	scripting-1
script	script
script1	
htmlscriptelement	htmlscriptelement
type3	attr-script-type
src	attr-script-src
charset2	attr-script-charset
async	attr-script-async
defer	attr-script-defer
already	already-executed
parser-inserted	parser-inserted
the-scripts	the-script's-type
the-scripts0	the-script's-character-encoding
running	running-a-script
completed	completed-loading
when-a	when-a-script-completes-loading
list-of	list-of-scripts-that-will-execute-when-the-document-has-finished-parsing
list-of0	list-of-scripts-that-will-execute-asynchronously
list-of1	list-of-scripts-that-will-execute-as-soon-as-possible
executing0	executing-a-script-block
src0	dom-script-src
type4	dom-script-type
charset3	dom-script-charset
async0	dom-script-async
defer0	dom-script-defer
text1	dom-script-text
scriptingLanguages	scriptingLanguages
support	support-the-scripting-language
the-noscript	the-noscript-element
noscript	
the-eventsource	the-eventsource-element
eventsource	
htmleventsourceelement	htmleventsourceelement
src1	attr-eventsource-src
add-declared	add-declared-event-source
remove1	remove-declared-event-source
src2	dom-eventsource-src
sections	sections
applyToSection	applyToSection
the-body	the-body-element
body0	
htmlbodyelement	htmlbodyelement
the-section	the-section-element
section	
the-nav	the-nav-element
nav	
the-article	the-article-element
article	
the-aside	the-aside-element
aside	
the-h1	the-h1,-h2,-h3,-h4,-h5,-and-h6-elements
h1	
h2	
h3	
h4	
h5	
h6	
rank	rank
the-header	the-header-element
header	
the-footer	the-footer-element
footer	
the-address	the-address-element
address	
headings	headings-and-sections
headings0	
sectioning1	sectioning-root
outlines	outlines
outline	outline
section0	concept-section
associatedSection	associatedSection
distinguishing	distinguishing-site-wide-headings-from-page-headings
grouping	grouping-content
the-p	the-p-element
p	
the-hr	the-hr-element
hr	
the-br	the-br-element
br	
the-pre	the-pre-element
pre	
the-dialog	the-dialog-element
dialog	
the-blockquote	the-blockquote-element
blockquote	
htmlquoteelement	htmlquoteelement
cite	attr-blockquote-cite
cite0	dom-quote-cite
the-ol	the-ol-element
ol	
htmlolistelement	htmlolistelement
reversed	attr-ol-reversed
start0	attr-ol-start
reversed0	dom-ol-reversed
start1	dom-ol-start
the-ul	the-ul-element
ul	
the-li	the-li-element
li	
htmllielement	htmllielement
value0	attr-li-value
value1	dom-li-value
the-dl	the-dl-element
dl	
the-dt	the-dt-element
dt	
the-dd	the-dd-element
dd	
text-level	text-level-semantics
the-a	the-a-element
a	
htmlanchorelement	htmlanchorelement
hyperlink2	hyperlink-suffix
href3	dom-a-href
ping0	dom-a-ping
target1	dom-a-target
rel1	dom-a-rel
media4	dom-a-media
hreflang1	dom-a-hreflang
type5	dom-a-type
rellist0	dom-a-rellist
the-q	the-q-element
q	
cite1	attr-q-cite
the-cite	the-cite-element
cite2	
the-em	the-em-element
em	
the-strong	the-strong-element
strong	
the-small	the-small-element
small	
the-mark	the-mark-element
mark	
the-dfn	the-dfn-element
dfn	
defining	defining-term
title4	attr-dfn-title
the-abbr	the-abbr-element
abbr	
title5	attr-abbr-title
the-time	the-time-element
time0	
htmltimeelement	htmltimeelement
datetime	attr-time-datetime
datetime0	dom-time-datetime
date0	concept-time-date
time1	concept-time-time
timezone	concept-time-timezone
date1	dom-time-date
time2	dom-time-time
timezone0	dom-time-timezone
the-progress	the-progress-element
progress	
htmlprogresselement	htmlprogresselement
value2	attr-progress-value
max	attr-progress-max
max0	dom-progress-max
value3	dom-progress-value
position	dom-progress-position
the-meter	the-meter-element
meter	
htmlmeterelement	htmlmeterelement
min	attr-meter-min
max1	attr-meter-max
value4	attr-meter-value
low	attr-meter-low
high	attr-meter-high
optimum	attr-meter-optimum
min0	dom-meter-min
max2	dom-meter-max
value5	dom-meter-value
low0	dom-meter-low
high0	dom-meter-high
optimum0	dom-meter-optimum
the-code	the-code-element
code	
the-var	the-var-element
var	
the-samp	the-samp-element
samp	
the-kbd	the-kbd-element
kbd	
the-sub	the-sub-and-sup-elements
sub	
sup	
the-span	the-span-element
span	
the-i	the-i-element
i	
the-b	the-b-element
b	
the-bdo	the-bdo-element
bdo	
the-ruby	the-ruby-element
ruby	
the-rt	the-rt-element
rt	
the-rp	the-rp-element
rp	
usage	usage-summary
footnotes	footnotes
edits	edits
the-ins	the-ins-element
ins	
the-del	the-del-element
del	
attributes	attributes-common-to-ins-and-del-elements
cite3	attr-mod-cite
datetime1	attr-mod-datetime
htmlmodelement	htmlmodelement
cite4	dom-mod-cite
datetime2	dom-mod-datetime
edits0	edits-and-paragraphs
edits1	edits-and-lists
embedded0	embedded-content-0
the-figure	the-figure-element
figure	
the-img	the-img-element
img	
htmlimageelement	htmlimageelement
src3	attr-img-src
alt0	attr-img-alt
ismap	attr-img-ismap
alt1	dom-img-alt
src4	dom-img-src
usemap	dom-img-usemap
ismap0	dom-img-ismap
width	dom-img-width
height	dom-img-height
complete	dom-img-complete
image0	dom-image
image1	dom-image-w
image2	dom-image-wh
alt	alt
a-link	a-link-or-button-containing-nothing-but-the-image
a-phrase	a-phrase-or-paragraph-with-an-alternative-graphical-representation:-charts,-diagrams,-graphs,-maps,-illustrations
a-short	a-short-phrase-or-label-with-an-alternative-graphical-representation:-icons,-logos
text-that	text-that-has-been-rendered-to-a-graphic-for-typographical-effect
a-graphical	a-graphical-representation-of-some-of-the-surrounding-text
a-purely	a-purely-decorative-image-that-doesn't-add-any-information-but-is-still-specific-to-the-surrounding-content
a-group	a-group-of-images-that-form-a-single-larger-picture-with-no-links
a-group0	a-group-of-images-that-form-a-single-larger-picture-with-links
a-key	a-key-part-of-the-content
an-image	an-image-not-intended-for-the-user
an-image0	an-image-in-an-e-mail-or-document-intended-for-a-specific-person-who-is-known-to-be-able-to-view-images
general	general-guidelines
the-iframe	the-iframe-element
iframe	
htmliframeelement	htmliframeelement
src5	attr-iframe-src
name1	attr-iframe-name
sandbox	attr-iframe-sandbox
sandboxed	sandboxed-navigation-browsing-context-flag
sandboxed0	sandboxed-plugins-browsing-context-flag
sandboxed1	sandboxed-annoyances-browsing-context-flag
sandboxed2	sandboxed-origin-browsing-context-flag
allow-same-origin	attr-iframe-sandbox-allow-same-origin
sandboxed3	sandboxed-forms-browsing-context-flag
allow-forms	attr-iframe-sandbox-allow-forms
sandboxed4	sandboxed-scripts-browsing-context-flag
allow-scripts	attr-iframe-sandbox-allow-scripts
seamless	attr-iframe-seamless
seamless0	seamless-browsing-context-flag
src6	dom-iframe-src
name2	dom-iframe-name
sandbox0	dom-iframe-sandbox
seamless1	dom-iframe-seamless
the-embed	the-embed-element
embed	
htmlembedelement	htmlembedelement
src7	attr-embed-src
type6	attr-embed-type
sandboxPluginEmbed	sandboxPluginEmbed
type-of	concept-embed-type
src8	dom-embed-src
type7	dom-embed-type
the-object	the-object-element
object	
htmlobjectelement	htmlobjectelement
data	attr-object-data
type8	attr-object-type
name3	attr-object-name
object-plugin	object-plugin
sandboxPluginObject	sandboxPluginObject
data0	dom-object-data
type9	dom-object-type
name4	dom-object-name
usemap0	dom-object-usemap
the-param	the-param-element
param	
htmlparamelement	htmlparamelement
name5	attr-param-name
value6	attr-param-value
parameter	concept-param-parameters
name6	dom-param-name
value7	dom-param-value
video	video
video1	
htmlvideoelement	htmlvideoelement
poster	attr-video-poster
poster0	poster-frame
poster1	dom-video-poster
intrinsic	concept-video-intrinsic-width
intrinsic0	concept-video-intrinsic-height
resolution	concept-video-resolution
pixel0	concept-video-pixel-ratio
videowidth	dom-video-videowidth
videoheight	dom-video-videoheight
adjusted	concept-video-adjusted-width
adjusted0	concept-video-adjusted-height
adjusted1	concept-video-adjusted-ratio
video0	video-and-audio-codecs-for-video-elements
audio	audio
audio1	
htmlaudioelement	htmlaudioelement
audio2	dom-audio
audio3	dom-audio-u
audio0	audio-codecs-for-audio-elements
the-source	the-source-element
source	
htmlsourceelement	htmlsourceelement
src9	attr-source-src
type10	attr-source-type
media5	attr-source-media
pixelratio	attr-source-pixelratio
src10	dom-source-src
type11	dom-source-type
media6	dom-source-media
pixelratio0	dom-source-pixelratio
media	media-elements
media7	media-element
htmlmediaelement	htmlmediaelement
media8	media-element-attributes
media9	media-data
media10	media-resource
media11	media-element-event-task-source
media12	media-element-new-resource-task-source
error	error-codes
error0	dom-media-error
mediaerror	mediaerror
code0	dom-mediaerror-code
mediaerraborted	dom-mediaerror-media_err_aborted
mediaerrnetwork	dom-mediaerror-media_err_network
mediaerrdecode	dom-mediaerror-media_err_decode
location	location-of-the-media-resource
src11	attr-media-src
src12	dom-media-src
pick-a	pick-a-media-resource
chosen	chosen-media-resource
pixel1	pixel-ratio-override
currentsrc	dom-media-currentsrc
network0	network-states
networkstate	dom-media-networkstate
empty	dom-media-empty
loading0	dom-media-loading
loadedmetadata	dom-media-loaded_metadata
loadedfirstframe	dom-media-loaded_first_frame
loaded	dom-media-loaded
loading	loading-the-media-resource
begun	begun-flag
loaded-first-frame	loaded-first-frame-flag
autoplaying	autoplaying-flag
load	dom-media-load
fatal-decode-error	fatal-decode-error
non-fatal-media-error	non-fatal-media-error
handling-first-frame-available	handling-first-frame-available
bufferingrate	dom-media-bufferingrate
bufferingthrottled	dom-media-bufferingthrottled
buffered	dom-media-buffered
bufferedbytes	dom-media-bufferedbytes
totalbytes	dom-media-totalbytes
offsets	offsets-into-the-media-resource
duration	dom-media-duration
durationChange	durationChange
current0	current-playback-position
currenttime	dom-media-currenttime
start2	attr-media-start
effective	effective-start
loopstart	attr-media-loopstart
effective0	effective-loop-start
loopend	attr-media-loopend
effective1	effective-loop-end
end	attr-media-end
effective2	effective-end
start3	dom-media-start
loopstart0	dom-media-loopstart
loopend0	dom-media-loopend
end0	dom-media-end
playcount	attr-media-playcount
playcount0	dom-media-playcount
currentloop	dom-media-currentloop
the-ready	the-ready-states
dataunavailable	dom-media-data_unavailable
canshowcurrentframe	dom-media-can_show_current_frame
canplay	dom-media-can_play
canplaythrough	dom-media-can_play_through
readystate0	dom-media-readystate
autoplay	attr-media-autoplay
autoplay0	dom-media-autoplay
playing	playing-the-media-resource
paused	dom-media-paused
actively	actively-playing
ended	ended-playback
stopped	stopped-due-to-errors
paused0	paused-for-user-interaction
media-playback	media-playback
fire-waiting-when-waiting	fire-waiting-when-waiting
defaultplaybackrate	dom-media-defaultplaybackrate
playbackrate	dom-media-playbackrate
rateUpdate	rateUpdate
play	dom-media-play
pause0	dom-media-pause
ended0	dom-media-ended
played	dom-media-played
seeking	seeking
seeking0	dom-media-seeking
seek	dom-media-seek
seekUpdate	seekUpdate
seekable	dom-media-seekable
cue-ranges	cue-ranges
cue-ranges0	cue-range
addcuerange	dom-media-addcuerange
removecueranges	dom-media-removecueranges
voidcallback	voidcallback
cuerangecallback	cuerangecallback
handleevent	
user-interface	user-interface
controls	attr-media-controls
expose	expose-a-user-interface-to-the-user
controls0	dom-media-controls
volume	dom-media-volume
muted	dom-media-muted
time-ranges	time-ranges
timeranges	timeranges
length3	dom-timeranges-length
start4	dom-timeranges-start
endindex	dom-timeranges-end
normalized	normalized-timeranges-object
byte-ranges	byte-ranges
byteranges	byteranges
length4	dom-byteranges-length
start5	dom-byteranges-start
endindex0	dom-byteranges-end
normalized0	normalized-byteranges-object
mediaevents	mediaevents
loadstart	event-loadstart
progress0	event-progress
loadedmetadata0	event-loadedmetadata
loadedfirstframe0	event-loadedfirstframe
load0	event-load
abort	event-abort
error1	event-error
emptied	event-emptied
stalled	event-stalled
play0	event-play
pause1	event-pause
waiting	event-waiting
seeking1	event-seeking
seeked	event-seeked
timeupdate	event-timeupdate
ended1	event-ended
dataunavailable0	event-dataunavailable
canshowcurrentframe0	event-canshowcurrentframe
canplay0	event-canplay
canplaythrough0	event-canplaythrough
ratechange	event-ratechange
durationchange	event-durationchange
volumechange	event-volumechange
security0	security-and-privacy-considerations
the-canvas	the-canvas-element
canvas	canvas
htmlcanvaselement	htmlcanvaselement
width0	attr-canvas-width
height0	attr-canvas-height
width1	dom-canvas-width
height1	dom-canvas-height
context0	context
getcontext	dom-canvas-getcontext
todataurl	dom-canvas-todataurl
todataurl0	dom-canvas-todataurl-type
the-2d	the-2d-context
d	canvas-context-2d
canvasrenderingcontext2d	canvasrenderingcontext2d
canvasgradient	canvasgradient
canvaspattern	canvaspattern
textmetrics	textmetrics
imagedata	imagedata
canvaspixelarray	canvaspixelarray
canvas0	dom-context-2d-canvas
the-canvas0	the-canvas-state
drawing0	drawing-state
save	dom-context-2d-save
restore	dom-context-2d-restore
transformations	transformations
transformations0	
scale	dom-context-2d-scale
rotate	dom-context-2d-rotate
translate	dom-context-2d-translate
transform	dom-context-2d-transform
settransform	dom-context-2d-settransform
compositing	compositing
globalalpha	dom-context-2d-globalalpha
globalcompositeoperation	dom-context-2d-globalcompositeoperation
source-atop	gcop-source-atop
source-in	gcop-source-in
source-out	gcop-source-out
source-over	gcop-source-over
destination-atop	gcop-destination-atop
destination-in	gcop-destination-in
destination-out	gcop-destination-out
destination-over	gcop-destination-over
lighter	gcop-lighter
copy	gcop-copy
xor	gcop-xor
refsPORTERDUFF	refsPORTERDUFF
colors	colors-and-styles
strokestyle	dom-context-2d-strokestyle
fillstyle	dom-context-2d-fillstyle
serialization	serialization-of-a-color
interpolation	interpolation
addcolorstop	dom-canvasgradient-addcolorstop
createlineargradient	dom-context-2d-createlineargradient
createradialgradient	dom-context-2d-createradialgradient
createpattern	dom-context-2d-createpattern
line-styles	line-styles
linewidth	dom-context-2d-linewidth
linecap	dom-context-2d-linecap
linejoin	dom-context-2d-linejoin
miterlimit	dom-context-2d-miterlimit
shadows	shadows
shadows0	
shadowcolor	dom-context-2d-shadowcolor
shadowoffsetx	dom-context-2d-shadowoffsetx
shadowoffsety	dom-context-2d-shadowoffsety
shadowblur	dom-context-2d-shadowblur
simple	simple-shapes-(rectangles)
clearrect	dom-context-2d-clearrect
fillrect	dom-context-2d-fillrect
strokerect	dom-context-2d-strokerect
complex	complex-shapes-(paths)
path	path
beginpath	dom-context-2d-beginpath
moveto	dom-context-2d-moveto
closepath	dom-context-2d-closepath
lineto	dom-context-2d-lineto
quadraticcurveto	dom-context-2d-quadraticcurveto
beziercurveto	dom-context-2d-beziercurveto
arcto	dom-context-2d-arcto
arcx-	dom-context-2d-arc
rectx	dom-context-2d-rect
fill	dom-context-2d-fill
stroke	dom-context-2d-stroke
clip	dom-context-2d-clip
clipping	clipping-region
ispointinpath	dom-context-2d-ispointinpath
text	text
font	dom-context-2d-font
textalign	dom-context-2d-textalign
textbaseline	dom-context-2d-textbaseline
top	dom-context-2d-textbaseline-top
hanging	dom-context-2d-textbaseline-hanging
middle	dom-context-2d-textbaseline-middle
alphabetic	dom-context-2d-textbaseline-alphabetic
ideographic	dom-context-2d-textbaseline-ideographic
bottom	dom-context-2d-textbaseline-bottom
filltext	dom-context-2d-filltext
stroketext	dom-context-2d-stroketext
measuretext	dom-context-2d-measuretext
width2	dom-textmetrics-width
images	images
drawimage	dom-context-2d-drawimage
pixel	pixel-manipulation
pixel2	
createimagedata	dom-context-2d-createimagedata
getimagedata	dom-context-2d-getimagedata
width3	dom-imagedata-width
height2	dom-imagedata-height
data1	dom-imagedata-data
length5	dom-canvaspixelarray-length
xxx5index	dom-canvaspixelarray-xxx5
xxx6index	dom-canvaspixelarray-xxx6
putimagedata	dom-context-2d-putimagedata
putimagedata0	dom-context-2d-putimagedata-dirty
drawing	drawing-model
3d	3d
color	color-spaces-and-color-correction
security1	security-with-canvas-elements
the-map	the-map-element
map	
htmlmapelement	htmlmapelement
name7	attr-map-name
areas	dom-map-areas
images1	dom-map-images
name8	dom-map-name
the-area	the-area-element
area	
htmlareaelement	htmlareaelement
alt2	attr-area-alt
shape	attr-area-shape
circ	attr-area-shape-keyword-circ
circle	attr-area-shape-keyword-circle
default0	attr-area-shape-keyword-default
poly	attr-area-shape-keyword-poly
polygon	attr-area-shape-keyword-polygon
rect	attr-area-shape-keyword-rect
rectangle	attr-area-shape-keyword-rectangle
coords	attr-area-coords
circle0	attr-area-shape-circle
default1	attr-area-shape-default
polygon0	attr-area-shape-poly
rectangle0	attr-area-shape-rect
alt3	dom-area-alt
coords0	dom-area-coords
href4	dom-area-href
target2	dom-area-target
ping1	dom-area-ping
rel2	dom-area-rel
media13	dom-area-media
hreflang2	dom-area-hreflang
type12	dom-area-type
shape0	dom-area-shape
rellist1	dom-area-rellist
image-maps	image-maps
authoring	authoring
image3	image-map
usemap1	attr-hyperlink-usemap
processing	processing-model
refsGRAPHICS	refsGRAPHICS
mathml	mathml
svg	svg
dimension	dimension-attributes
dimension0	
width4	attr-dim-width
height3	attr-dim-height
width5	dom-dim-width
height4	dom-dim-height
tabular	tabular-data
table-intro	table-intro
the-table	the-table-element
table	
htmltableelement	htmltableelement
caption	dom-table-caption
createcaption	dom-table-createcaption
deletecaption	dom-table-deletecaption
thead	dom-table-thead
createthead	dom-table-createthead
deletethead	dom-table-deletethead
tfoot	dom-table-tfoot
createtfoot	dom-table-createtfoot
deletetfoot	dom-table-deletetfoot
tbodies	dom-table-tbodies
createtbody	dom-table-createtbody
rows	dom-table-rows
insertrow	dom-table-insertrow
deleterow	dom-table-deleterow
the-caption	the-caption-element
caption0	
the-colgroup	the-colgroup-element
colgroup	
htmltablecolelement	htmltablecolelement
span0	attr-colgroup-span
span1	dom-colgroup-span
the-col	the-col-element
col	
span2	attr-col-span
span3	dom-col-span
the-tbody	the-tbody-element
tbody	
htmltablesectionelement	htmltablesectionelement
rows0	dom-tbody-rows
insertrow0	dom-tbody-insertrow
deleterow0	dom-tbody-deleterow
the-thead	the-thead-element
thead0	
the-tfoot	the-tfoot-element
tfoot0	
the-tr	the-tr-element
tr	
htmltablerowelement	htmltablerowelement
rowindex	dom-tr-rowindex
sectionrowindex	dom-tr-sectionrowindex
cells	dom-tr-cells
insertcell	dom-tr-insertcell
deletecell	dom-tr-deletecell
the-td	the-td-element
td	
htmltabledatacellelement	htmltabledatacellelement
headers	attr-td-headers
headers0	dom-td-headers
the-th	the-th-element
th	
htmltableheadercellelement	htmltableheadercellelement
scope0	attr-th-scope
row	attr-th-scope-row
col0	attr-th-scope-col
rowgroup	attr-th-scope-rowgroup
colgroup0	attr-th-scope-colgroup
scope1	dom-th-scope
attributes0	attributes-common-to-td-and-th-elements
colspan	attr-tdth-colspan
rowspan	attr-tdth-rowspan
htmltablecellelement	htmltablecellelement
colspan0	dom-tdth-colspan
rowspan0	dom-tdth-rowspan
cellindex	dom-tdth-cellindex
processing0	processing-model-0
table0	table-model
table1	concept-table
slots	concept-slots
cell	concept-cell
row0	concept-row
column	concept-column
row-group	concept-row-group
column0	concept-column-group
table2	table-model-error
forming	forming-a-table
advanced	concept-table-advance
algorithm0	algorithm-for-processing-row-groups
algorithm1	algorithm-for-ending-a-row-group
algorithm2	algorithm-for-processing-rows
algorithm3	algorithm-for-growing-downward-growing-cells
header-and-data-cell-semantics	header-and-data-cell-semantics
algorithm4	algorithm-for-assigning-header-cells-to-data-cells
equivalent	equivalent-to-a-wide-cell
empty0	empty-data-cell
forms	forms
form-associated	form-associated-element
submittable	category-submit
resettable	category-reset
listed	category-listed
labelable	category-label
buttons	concept-button
the-form	the-form-element
form	
htmlformelement	htmlformelement
accept-charset	attr-form-accept-charset
name9	attr-form-name
accept-charset0	dom-form-accept-charset
name10	dom-form-name
elements3	dom-form-elements
length6	dom-form-length
xxx7	dom-form-xxx7
xxx8	dom-form-xxx8
submit0	dom-form-submit
reset0	dom-form-reset
checkvalidity	dom-form-checkvalidity
dispatchforminput	dom-form-dispatchforminput
dispatchformchange	dom-form-dispatchformchange
the-fieldset	the-fieldset-element
fieldset	
htmlfieldsetelement	htmlfieldsetelement
disabled2	attr-fieldset-disabled
disabled3	dom-fieldset-disabled
type13	dom-fieldset-type
elements4	dom-fieldset-elements
the-label	the-label-element
label	
htmllabelelement	htmllabelelement
labeled	labeled-control
for	attr-label-for
htmlfor	dom-label-htmlfor
control	dom-label-control
labels	dom-lfe-labels
the-input	the-input-element
input0	
htmlinputelement	htmlinputelement
type14	attr-input-type
text2	attr-input-type-text-keyword
email	attr-input-type-email-keyword
url1	attr-input-type-url-keyword
password0	attr-input-type-password-keyword
datetime3	attr-input-type-datetime-keyword
date2	attr-input-type-date-keyword
month1	attr-input-type-month-keyword
week0	attr-input-type-week-keyword
time3	attr-input-type-time-keyword
datetime-local	attr-input-type-datetime-local-keyword
number1	attr-input-type-number-keyword
range0	attr-input-type-range-keyword
checkbox0	attr-input-type-checkbox-keyword
radio0	attr-input-type-radio-keyword
file	attr-input-type-file-keyword
hidden0	attr-input-type-hidden-keyword
submit1	attr-input-type-submit-keyword
image4	attr-input-type-image-keyword
reset1	attr-input-type-reset-keyword
button0	attr-input-type-button-keyword
value8	value-sanitization-algorithm
algorithm5	concept-input-value-string-number
algorithm6	concept-input-value-number-string
algorithm7	concept-input-value-string-date
algorithm8	concept-input-value-date-string
mutability	concept-input-mutability
mutable	concept-input-mutable
immutable	concept-input-immutable
dirty	concept-input-dirty-flag
dirty0	concept-input-dirty
value9	attr-input-value
accept	dom-input-accept
alt4	dom-input-alt
autocomplete	dom-input-autocomplete
max3	dom-input-max
min1	dom-input-min
pattern	dom-input-pattern
required	dom-input-required
size	dom-input-size
src13	dom-input-src
step	dom-input-step
type15	dom-input-type
maxlength	dom-input-maxlength
readonly	dom-input-readonly
defaultchecked	dom-input-defaultchecked
defaultvalue	dom-input-defaultvalue
states	states-of-the-type-attribute
text-state	text-state
text3	
e-mail	e-mail-state
e-mail0	
url-state	url-state
url2	
password	password-state
password1	
date-and	date-and-time-state
date-and0	
date-state	date-state
date3	
month	month-state
month2	
week-state	week-state
week1	
time-state	time-state
time4	
local0	local-date-and-time-state
local2	
number	number-state
number2	
range	range-state
range1	
default2	concept-input-value-default-range
checkbox	checkbox-state
checkbox1	
checked	concept-input-checked-checkbox
radio	radio-button-state
radio1	
checked0	concept-input-checked-radio
file-state	file-state
file0	
accept0	attr-input-accept
selected	concept-input-type-file-selected
hidden	hidden-state
hidden1	
submit	submit-button-state
submit2	
image	image-button-state
image5	
selected0	concept-input-type-image-coordinate
reset	reset-button-state
reset2	
button	button-state
button1	
common3	common-algorithms
strip	strip-line-breaks-from-the-value
common4	common-input-element-attributes
the-autocomplete	the-autocomplete-attribute
autocomplete0	attr-input-autocomplete
on	attr-input-autocomplete-on-state
off	attr-input-autocomplete-off-state
the-maxlength	the-maxlength-attribute
maxlength0	attr-input-maxlength
codepoint	codepoint-length
maximum	maximum-allowed-value-length
the-readonly	the-readonly-attribute
readonly0	attr-input-readonly
the-min	the-min-and-max-attributes
min2	attr-input-min
max4	attr-input-max
minimum	concept-input-min
default3	concept-input-min-default
maximum0	concept-input-max
default4	concept-input-max-default
the-step	the-step-attribute
step0	attr-input-step
default5	concept-input-step-default
step-	concept-input-step-scale
allowed	concept-input-step
step-base	concept-input-min-zero
common5	common-input-element-apis
value	value-manipulation
value10	dom-input-value
valueasdate	dom-input-valueasdate
valueasnumber	dom-input-valueasnumber
stepup	dom-input-stepup
stepdown	dom-input-stepdown
others...	others...
checked1	dom-input-checked
list	dom-input-list
selectedoption	dom-input-selectedoption
the-button	the-button-element
button2	
htmlbuttonelement	htmlbuttonelement
the-select	the-select-element
select	
htmlselectelement	htmlselectelement
the-datalist	the-datalist-element
datalist	
htmldatalistelement	htmldatalistelement
the-optgroup	the-optgroup-element
optgroup	
htmloptgroupelement	htmloptgroupelement
the-option	the-option-element
option	
htmloptionelement	htmloptionelement
selected1	concept-option-selected
value11	concept-option-value
option0	dom-option
option1	dom-option-n
option2	dom-option-nv
the-textarea	the-textarea-element
textarea	
htmltextareaelement	htmltextareaelement
the-output	the-output-element
output	
htmloutputelement	htmloutputelement
association	association-of-controls-and-forms
form-owner	form-owner
form0	attr-fae-form
associated	concept-form-association
reset3	reset-the-form-owner
form1	dom-fae-form
attributes1	attributes-common-to-form-controls
attributes4	
naming	naming-form-controls
name11	attr-fe-name
name12	dom-fe-name
enabling	enabling-and-disabling-form-controls
disabled4	concept-fe-disabled
disabled5	attr-fe-disabled
disabled6	dom-fe-disabled
a-form	a-form-control's-value
value12	concept-fe-value
autofocusing	autofocusing-a-form-control
autofocus	attr-fe-autofocus
autofocus0	dom-fe-autofocus
attributes2	attributes-for-form-submission
attributes5	
action	attr-fs-action
action0	dom-fs-action
action1	concept-fs-action
method	attr-fs-method
method0	dom-fs-method
method1	concept-fs-method
enctype	attr-fs-enctype
enctype0	dom-fs-enctype
enctype1	concept-fs-enctype
target3	attr-fs-target
target4	dom-fs-target
target5	concept-fs-target
constraints	constraints
definitions	definitions
candidate	candidate-for-constraint-validation
barred	barred-from-constraint-validation
satisfies	concept-fv-valid
suffering	suffering-from-a-type-mismatch
suffering0	suffering-from-being-too-long
suffering1	suffering-from-an-underflow
suffering2	suffering-from-an-overflow
suffering3	suffering-from-a-step-mismatch
constraint	constraint-validation
statically	statically-validate-the-constraints
interactively	interactively-validate-the-constraints
the-constraint	the-constraint-validation-api
constraint0	
willvalidate	dom-cva-willvalidate
validity	dom-cva-validity
validationmessage	dom-cva-validationmessage
checkvalidity0	dom-cva-checkvalidatity
setcustomvalidity	dom-cva-setcustomvalidity
form-submission	form-submission
submitted	concept-form-submit
sandboxSubmitBlocked	sandboxSubmitBlocked
constructing-form-data-set	constructing-form-data-set
mutate	submit-mutate-action
submit3	submit-body
delete	submit-delete-action
get-action	submit-get-action
post-to	submit-data-post
put-to	submit-data-put
mail-with	submit-mailto-headers
mail-as	submit-mailto-body
the-form0	the-form-submission-target-browsing-context
appropriate	appropriate-form-encoding-algorithm
url-encoded	url-encoded-form-data
applicationx-www-form-urlencoded	application/x-www-form-urlencoded-encoding-algorithm
multipart	multipart-form-data
multipartform-data	multipart/form-data-encoding-algorithm
plain	plain-text-form-data
textplain	text/plain-encoding-algorithm
resetting	resetting-a-form
reset4	concept-form-reset
reset5	concept-form-reset-control
event	event-dispatch
broadcast	broadcast-forminput-events
broadcast0	broadcast-formchange-events
interactive-elements	interactive-elements
the-details	the-details-element
details	
htmldetailselement	htmldetailselement
open0	attr-details-open
open1	dom-details-open
datagrid	datagrid
datagrid0	
htmldatagridelement	htmldatagridelement
multiple	dom-datagrid-multiple
disabled7	dom-datagrid-disabled
the-datagrid	the-datagrid-data-model
how-rows	how-rows-are-identified
rowspecification	rowspecification
the-data	the-data-provider-interface
datagriddataprovider	datagriddataprovider
data2	dom-datagrid-data
initialize	dom-provider-initialize
getrowcount	dom-provider-getrowcount
getchildatposition	dom-provider-getchildatposition
getcolumncount	dom-provider-getcolumncount
getcaptiontext	dom-provider-getcaptiontext
getcaptionclasses	dom-provider-getcaptionclasses
getrowimage	dom-provider-getrowimage
getrowmenu	dom-provider-getrowmenu
getrowclasses	dom-provider-getrowclasses
getcelldata	dom-provider-getcelldata
getcellclasses	dom-provider-getcellclasses
togglecolumnsortstate	dom-provider-togglecolumnsortstate
setcellcheckedstate	dom-provider-setcellcheckedstate
cyclecell	dom-provider-cyclecell
editcell	dom-provider-editcell
datagridClassSummary	datagridClassSummary
checked2	datagrid-cell-class-checked
cyclable	datagrid-cell-class-cyclable
editable	datagrid-cell-class-editable
header0	datagrid-row-class-header
indeterminate	datagrid-cell-class-indeterminate
initially-hidden	datagrid-column-class-initially-hidden
initially-closed	datagrid-row-class-initially-closed
initially-open	datagrid-row-class-initially-open
progress1	datagrid-cell-class-progress
reversed1	datagrid-column-class-reversed
selectable-separator	datagrid-row-class-selectable-separator
separator	datagrid-row-class-separator
sortable	datagrid-column-class-sortable
sorted	datagrid-column-class-sorted
unchecked	datagrid-cell-class-unchecked
the-default	the-default-data-provider
defaultDataProviderTableMapper	defaultDataProviderTableMapper
defaultDataProviderTableSort	defaultDataProviderTableSort
generic-provider-selection	generic-provider-selection
commonDefaultDataGridMethodDefinitions	commonDefaultDataGridMethodDefinitions
populating	populating-the-datagrid-element
columnType2	columnType2
rowType1	rowType1
cellType1	cellType1
cellType2	cellType2
inconsistentDataProvider	inconsistentDataProvider
updating	updating-the-datagrid
updateeverything	dom-datagrid-updateeverything
updaterowschanged	dom-datagrid-updaterowschanged
updaterowsinserted	dom-datagrid-updaterowsinserted
updaterowsremoved	dom-datagrid-updaterowsremoved
updaterowchanged	dom-datagrid-updaterowchanged
updatecolumnchanged	dom-datagrid-updatecolumnchanged
updatecellchanged	dom-datagrid-updatecellchanged
requirements	requirements-for-interactive-user-agents
disabled8	attr-datagrid-disabled
the-selection	the-selection
datagridselection	datagridselection
selection0	dom-datagrid-selection
length7	dom-datagridselection-length
itemindex3	dom-datagridselection-item
isselected	dom-datagridselection-isselected
setselected	dom-datagridselection-setselected
selectall	dom-datagridselection-selectall
invert	dom-datagridselection-invert
clear	dom-datagridselection-clear
multiple0	attr-datagrid-multiple
select0	event-select
columns	columns-and-captions
the-command	the-command
command0	
htmlcommandelement	htmlcommandelement
type16	attr-command-type
label0	attr-command-label
title6	attr-command-title
icon	attr-command-icon
disabled9	attr-command-disabled
checked3	attr-command-checked
radiogroup	attr-command-radiogroup
default6	attr-command-default
type17	dom-command-type
label1	dom-command-label
icon0	dom-command-icon
disabled10	dom-command-disabled
checked4	dom-command-checked
radiogroup0	dom-command-radiogroup
default7	dom-command-default
click	dom-command-click
the-bb	the-bb-element
bb	
htmlbrowserbuttonelement	htmlbrowserbuttonelement
type18	attr-bb-type
makeapp	attr-bb-type-makeapp
null	attr-bb-type-null-state
type19	dom-bb-type
supported	dom-bb-supported
disabled11	dom-bb-disabled
browser	browser-button-types
the-make	the-make-application-state
make-application	
menus	menus
menu	
htmlmenuelement	htmlmenuelement
type20	attr-menu-type
context1	context-menu-state
tool-bar	tool-bar-state
list0	list-state
label2	attr-menu-label
type21	dom-menu-type
label3	dom-menu-label
menus-intro	menus-intro
building	building-menus-and-tool-bars
building0	
context	context-menus
context2	
contextmenu	attr-contextmenu
contextmenu0	dom-contextmenu
toolbars	toolbars
toolbars0	toolbars-0
commands	commands
command1	concept-command
facets	facets
facets0	concept-facet
type22	command-facet-type
id1	command-facet-id
anonymous	anonymous-command
label4	command-facet-label
hint	command-facet-hint
icon1	command-facet-icon
hidden2	command-facet-hiddenstate
disabled12	command-facet-disabledstate
checked5	command-facet-checkedstate
action2	command-facet-action
triggers	command-facet-triggers
command2	command-ro
commandtype	dom-command-ro-commandtype
id2	dom-command-ro-id
label5	dom-command-ro-label
title7	dom-command-ro-title
icon2	dom-command-ro-icon
hidden3	dom-command-ro-hidden
disabled13	dom-command-ro-disabled
checked6	dom-command-ro-checked
click0	dom-command-ro-click
triggers0	dom-command-ro-triggers
commands0	dom-document-commands
using	using-the-a-element-to-define-a-command
using5	
using0	using-the-button-element-to-define-a-command
using6	
using1	using-the-input-element-to-define-a-command
using7	
using2	using-the-option-element-to-define-a-command
using8	
using3	using-the-command-element-to-define-a-command
command3	
using4	using-the-bb-element-to-define-a-command
using9	
datatemplate	datatemplate
introduction0	introduction-0
the-datatemplate	the-datatemplate-element
datatemplate0	
the-rule	the-rule-element
rule	
htmlruleelement	htmlruleelement
condition	attr-rule-condition
mode	attr-rule-mode
condition0	dom-rule-condition
mode0	dom-rule-mode
modelist	dom-rule-modelist
the-nest	the-nest-element
nest	
htmlnestelement	htmlnestelement
filter	attr-nest-filter
mode1	attr-nest-mode
filter0	dom-nest-filter
mode2	dom-nest-mode
global0	global-attributes-for-data-templates
template	attr-template
template0	dom-template
ref	attr-ref
ref0	dom-ref
registrationmark	attr-registrationmark
registrationmark0	dom-registrationmark
processing1	processing-model-1
template1	template-task-source
the-originalcontent	the-originalcontent-dom-attribute
originalcontent	dom-originalcontent
the-template	the-template-attribute
setting	datatemplate-template-set
failed	datatemplate-template-failed
unsetting	datatemplate-template-unset
templateelement	dom-templateelement
the-ref	the-ref-attribute
setting0	datatemplate-ref-set
failed0	datatemplate-ref-failed
unsetting0	datatemplate-ref-unset
refnode	dom-refnode
the-nodedatatemplate	the-nodedatatemplate-interface
nodedatatemplate	nodedatatemplate
datanode	dom-datanode
mutations	mutations
data-tree	data-tree-user
data-tree0	data-tree-component-node
template2	template-tree-user
template3	template-tree-component-node
updating0	updating-the-generated-content
update	datatemplate-regen
levenberg	levenberg-data-node-algorithm
levenberg0	levenberg-template-node-algorithm
evaluated	evaluated-as-a-selector
text-expansion	text-expansion-algorithm-for-templates
miscellaneous	miscellaneous-elements
the-legend	the-legend-element
legend	
the-div	the-div-element
div	
browsers	browsers
windows	windows
browsing1	browsing-context
active	active-document
view	view
default8	default-view
about-blank-origin	about-blank-origin
nested	nested-browsing-contexts
nested0	nested-browsing-context
parent	parent-browsing-context
child	child-browsing-context
nested1	browsing-context-nested-through
browsing2	browsing-context-container
top-level	top-level-browsing-context
ancestor	ancestor-browsing-context
fully	fully-active
navigating	navigating-nested-browsing-contexts-in-the-dom
top0	dom-top
parent0	dom-parent
frameelement	dom-frameelement
auxiliary	auxiliary-browsing-contexts
auxiliary0	auxiliary-browsing-context
opener	opener-browsing-context
furthest	furthest-ancestor-browsing-context
navigating0	navigating-auxiliary-browsing-contexts-in-the-dom
opener0	dom-opener
secondary	secondary-browsing-contexts
secondary0	secondary-browsing-context
security2	security-0
allowed0	allowed-to-navigate
groupings	groupings-of-browsing-contexts
directly	directly-reachable-browsing-contexts
unit-of	unit-of-related-browsing-contexts
unit-of0	unit-of-related-similar-origin-browsing-contexts
browsing	browsing-context-names
browsing3	browsing-context-name
valid15	valid-browsing-context-name
valid16	valid-browsing-context-name-or-keyword
the-rules	the-rules-for-choosing-a-browsing-context-given-a-browsing-context-name
sandboxWindowOpen	sandboxWindowOpen
noopener	noopener
the-default0	the-default-view
window	window
window0	dom-window
frames	dom-frames
self	dom-self
list-of2	list-of-added-properties
security3	security-1
apis-for	apis-for-creating-and-navigating-browsing-contexts-by-name
open2	dom-open
name13	dom-name
accessing	accessing-other-browsing-contexts
length8	dom-length
xxx4index	dom-xxx4
origin	origin
origin0	origin-0
effective3	effective-script-origin
sandboxOrigin	sandboxOrigin
unicode	unicode-serialization-of-an-origin
ascii0	ascii-serialization-of-an-origin
same-origin	same-origin
relaxing	relaxing-the-same-origin-restriction
domain	dom-document-domain
domain0	the-document's-domain
scripting	scripting
script0	script-execution-contexts
script2	script-execution-context
script3	script-browsing-context
script4	script-document-context
scripting2	scripting-is-disabled
designModeScriptBlocked	designModeScriptBlocked
sandboxScriptBlocked	sandboxScriptBlocked
without	without-script
with-script	with-script
event0	event-loops
event4	event-loop
task-queues	task-queue
tasks	concept-task
queue	queue-a-task
task-source	task-source
generic	generic-task-sources
dom-manipulation	dom-manipulation-task-source
user-interaction	user-interaction-task-source
networking	networking-task-source
security4	security-exceptions
security10	security-exception
javascript-protocol	javascript-protocol
the-javascript	
dereferenced	concept-js-deref
events	events
event-handler-attributes	event-handler-attributes
event5	event-handler-attributes-0
event6	event-handler-content-attributes
event7	event-handler-dom-attributes
onabort	handler-onabort
onbeforeunload	handler-onbeforeunload
onblur	handler-onblur
onchange	handler-onchange
onclick	handler-onclick
oncontextmenu	handler-oncontextmenu
ondblclick	handler-ondblclick
ondrag	handler-ondrag
ondragend	handler-ondragend
ondragenter	handler-ondragenter
ondragleave	handler-ondragleave
ondragover	handler-ondragover
ondragstart	handler-ondragstart
ondrop	handler-ondrop
onerror	handler-onerror
onfocus	handler-onfocus
onhashchange	handler-onhashchange
onkeydown	handler-onkeydown
onkeypress	handler-onkeypress
onkeyup	handler-onkeyup
onload	handler-onload
onmessage	handler-onmessage
onmousedown	handler-onmousedown
onmousemove	handler-onmousemove
onmouseout	handler-onmouseout
onmouseover	handler-onmouseover
onmouseup	handler-onmouseup
onmousewheel	handler-onmousewheel
onresize	handler-onresize
onscroll	handler-onscroll
onselect	handler-onselect
onstorage	handler-onstorage
onsubmit	handler-onsubmit
onunload	handler-onunload
event1	event-firing
firing	fire-a-click-event
firing0	fire-a-change-event
firing1	fire-a-contextmenu-event
firing2	fire-a-simple-event
firing3	fire-a-show-event
firing4	fire-a-load-event
firing5	fire-an-error-event
firing6	fire-a-progress-event
events0	events-and-the-window-object
runtime-script-errors	runtime-script-errors
user-prompts	user-prompts
simple0	simple-dialogs
alert	dom-alert
confirm	dom-confirm
prompt	dom-prompt
printing	printing
print	dom-print
printing0	printing-steps
dialogs	dialogs-implemented-using-separate-documents
showmodaldialog	dom-showmodaldialog
modalwindow	modalwindow
dialog0	dialog-arguments
dialog1	dialog-arguments'-origin
dialogarguments	dom-modalwindow-dialogarguments
return	return-value
returnvalue	dom-modalwindow-returnvalue
notifications	notifications
trusted	trusted-notification-source
shownotification	dom-shownotification
sandboxNotifications	sandboxNotifications
sandboxed5	sandboxed-notification
normal	normal-notification
trusted0	trusted-notification
system	system-state-and-capabilities
navigator	dom-navigator
navigator0	navigator
client	client-identification
appname	dom-navigator-appname
appversion	dom-navigator-appversion
platform	dom-navigator-platform
useragent	dom-navigator-useragent
custom-handlers	custom-handlers
registerprotocolhandler	dom-navigator-registerprotocolhandler
registercontenthandler	dom-navigator-registercontenthandler
security5	security-and-privacy
sample-handler-impl	sample-handler-impl
offline	offline
introduction1	introduction-1
appcache	appcache
application0	application-cache
update0	concept-appcache-status
appcache-history-1	appcache-history-1
implicit	concept-appcache-implicit
the-manifest	concept-appcache-manifest
explicit	concept-appcache-explicit
foreign	concept-appcache-foreign
fallback0	concept-appcache-fallback
opportunistically	concept-appcache-oppcache
dynamic4	concept-appcache-dynamic
opportunistic	concept-appcache-oppcache-ns
online	concept-appcache-onlinewhitelist
select1	concept-appcache-selection
manifests	manifests
a-sample	a-sample-manifest
writing	writing-cache-manifests
parsing1	parsing-cache-manifests
parse7	parse-a-manifest
updating1	updating-an-application-cache
application1	application-cache-update-process
upgrade	concept-appcache-upgrade
cache	concept-appcache-cache
flagAsCandidateForCache-result	flagAsCandidateForCache-result
cache0	cache-failure-steps
processing2	processing-model-2
matches	concept-appcache-matches-oppcache
application2	concept-appcache-init-with-attribute
flagAsCandidateForCache	flagAsCandidateForCache
application3	concept-appcache-init-no-attribute
changesToNetworkingModel	changesToNetworkingModel
application	application-cache-api
applicationcache	applicationcache
applicationcache0	dom-applicationcache
status0	dom-appcache-status
uncached	dom-appcache-uncached
idle	dom-appcache-idle
checking	dom-appcache-checking
downloading	dom-appcache-downloading
updateready	dom-appcache-updateready
length9	dom-appcache-length
itemindex4	dom-appcache-item
addurl	dom-appcache-add
remove2	dom-appcache-remove
update1	dom-appcache-update
swapcache	dom-appcache-swapcache
onchecking	handler-appcache-onchecking
onerror0	handler-appcache-onerror
onnoupdate	handler-appcache-onnoupdate
ondownloading	handler-appcache-ondownloading
onprogress	handler-appcache-onprogress
onupdateready	handler-appcache-onupdateready
oncached	handler-appcache-oncached
browser0	browser-state
navigator.online	dom-navigator-online
offline0	event-offline
online0	event-online
history	history
the-session	the-session-history-of-browsing-contexts
session	session-history
history2	dom-history
session0	session-history-entry
state	state-object
last-activated	last-activated-entry
current1	current-entry
the-history	the-history-interface
history3	history-1
length10	dom-history-length
godelta	dom-history-go
go	dom-history-go-0
back	dom-history-back
forward	dom-history-forward
pushstate	dom-history-pushstate
clearstate	dom-history-clearstate
activating	activating-state-object-entries
activating0	
popstate	event-popstate
popstateevent	popstateevent
initpopstateevent	dom-popstateevent-initpopstateevent
initpopstateeventns	dom-popstateevent-initpopstateeventns
state0	dom-popstateevent-state
the-location	the-location-interface
location0	dom-document-location
location1	dom-location
location2	location
href5	dom-location-href
assign	dom-location-assign
replace	dom-location-replace
protocol0	dom-location-protocol
host0	dom-location-host
port0	dom-location-port
hostname0	dom-location-hostname
pathname0	dom-location-pathname
search0	dom-location-search
hash0	dom-location-hash
security6	security-2
history-notes	history-notes
browsing0	browsing-the-web
navigating1	navigating-across-documents
navigate	navigate
source0	source-browsing-context
sandboxLinks	sandboxLinks
seamlessLinks	seamlessLinks
navigate-fragid-step	navigate-fragid-step
navigate-non-Document	navigate-non-Document
update2	update-the-session-history-with-the-new-page
entry	entry-update
replacement	replacement-enabled
read-html	read-html
page-load	
read-xml	read-xml
page-load0	
read-text	read-text
page-load1	
read-image	read-image
page-load2	
read-plugin	read-plugin
page-load3	
sandboxPluginNavigate	sandboxPluginNavigate
read-ua-inline	read-ua-inline
page-load4	
scroll-to-fragid	scroll-to-fragid
navigating2	
scroll	scroll-to-the-fragment-identifier
the-indicated	the-indicated-part-of-the-document
history1	history-traversal
traverse	traverse-the-history
resetBCName	resetBCName
appcache-history-2	appcache-history-2
closing	closing-a-browsing-context
discard	discard-a-document
structured	structured-client-side-storage
storage	storage
introduction2	introduction-2
the-storage	the-storage-interface
storage0	storage-0
length11	dom-storage-length
keyn	dom-storage-key
getitem	dom-storage-getitem
setitem	dom-storage-setitem
removeitem	dom-storage-removeitem
clear0	dom-storage-clear
the-sessionstorage	the-sessionstorage-attribute
sessionstorage	dom-sessionstorage
sessionStorageEvent	sessionStorageEvent
the-localstorage	the-localstorage-attribute
localstorage	dom-localstorage
localStorageEvent	localStorageEvent
the-storage0	the-storage-event
storage1	event-storage
event2	event-definition
storageevent	storageevent
initstorageevent	dom-storageevent-initstorageevent
initstorageeventns	dom-storageevent-initstorageeventns
key	dom-storageevent-key
oldvalue	dom-storageevent-oldvalue
newvalue	dom-storageevent-vnewvalue
url3	dom-storageevent-url
source1	dom-storageevent-source
threads	threads
sql	sql
introduction3	introduction-3
databases	databases
opendatabase	dom-opendatabase
database0	database
sqltransactioncallback	sqltransactioncallback
sqltransactionerrorcallback	sqltransactionerrorcallback
transaction	dom-database-transaction
expected	concept-database-expected-version
version	dom-database-version
changeversion	dom-database-changeversion
executing	executing-sql-statements
objectarray	objectarray
sqltransaction	sqltransaction
sqlstatementcallback	sqlstatementcallback
sqlstatementerrorcallback	sqlstatementerrorcallback
executesql	dom-sqltransaction-executesql
database	database-query-results
sqlresultset	sqlresultset
insertid	dom-sqlresultset-insertid
rowsaffected	dom-sqlresultset-rowsaffected
rows1	dom-sqlresultset-rows
sqlresultsetrowlist	sqlresultsetrowlist
length12	dom-sqlresultsetrowlist-length
itemindex5	dom-sqlresultsetrowlist-item
errors	errors
sqlerror	sqlerror
code1	dom-sqlerror-code
x	dom-sqlerror-code-0
x0	dom-sqlerror-code-1
x1	dom-sqlerror-code-2
x2	dom-sqlerror-code-3
x3	dom-sqlerror-code-4
x4	dom-sqlerror-code-5
x5	dom-sqlerror-code-6
message1	dom-sqlerror-message
processing3	processing-model-3
transaction0	transaction-steps
disk-space	disk-space
privacy	privacy
user-tracking	user-tracking
cookie	cookie-resurrection
security7	security-3
dns-spoofing	dns-spoofing-attacks
cross-directory	cross-directory-attacks
implementation	implementation-risks
sql-and	sql-and-user-agents
sql-injection	sql-injection
links	links
hyperlink	hyperlink-elements
hyperlinks	hyperlink
href6	attr-hyperlink-href
target6	attr-hyperlink-target
ping	ping
rel3	attr-hyperlink-rel
media14	attr-hyperlink-media
hreflang3	attr-hyperlink-hreflang
type23	attr-hyperlink-type
following	following-hyperlinks
following0	
hyperlink0	hyperlink-auditing
linkTypes	linkTypes
link-type	link-type-alternate
alternate	
link-type0	link-type-archives
archives	
link-type1	link-type-author
author	
link-type2	link-type-bookmark
bookmark	
link-type3	link-type-external
external	
link-type4	link-type-feed
feed	
link-type5	link-type-help
help	
rel-icon	rel-icon
icon3	
sizes0	attr-link-sizes
any	attr-link-sizes-any
link-type6	link-type-license
license	
link-type7	link-type-nofollow
nofollow	
link-type8	link-type-noreferrer
noreferrer	
link-type9	link-type-pingback
pingback	
link-type10	link-type-prefetch
prefetch	
link-type11	link-type-search
search1	
link-type12	link-type-stylesheet
stylesheet	
link-type13	link-type-sidebar
sidebar	
sidebar0	rel-sidebar-hyperlink
link-type14	link-type-tag
tag	
hierarchical	hierarchical-link-types
link-type15	link-type-index
index0	
link-type16	link-type-up
up	
sequential	sequential-link-types
link-type17	link-type-first
first	
link-type18	link-type-last
last	
link-type19	link-type-next
next	
link-type20	link-type-prev
prev	
other0	other-link-types
editing	editing
user-interaction0	
editing-intro	editing-intro
the-hidden	the-hidden-attribute
hidden4	
hidden5	dom-hidden
activation	activation
click1	dom-click
scrolling	scrolling-elements-into-view
scrollintoview	dom-scrollintoview
focus	focus
sequential0	sequential-focus-navigation
tabindex	attr-tabindex
negative-tabindex	negative-tabindex
focusable	focusable
tabindex0	dom-tabindex
focus-management	focus-management
focusing	focusing-steps
unfocusing	unfocusing-steps
document-level	document-level-focus-apis
activeelement	dom-document-activeelement
hasfocus	dom-document-hasfocus
element-level	element-level-focus-apis
focus0	dom-focus
locked	locked-for-focus
blur	dom-blur
selection	selection
a-selection	the-selection-0
text-field	text-field-selection
documentSelection	documentSelection
getselection	dom-getselection
getselection0	dom-document-getselection
selection1	selection-0
anchornode	dom-selection-anchornode
anchoroffset	dom-selection-anchoroffset
focusnode	dom-selection-focusnode
focusoffset	dom-selection-focusoffset
iscollapsed	dom-selection-iscollapsed
collapse	dom-selection-collapse
collapsetostart	dom-selection-collapsetostart
collapsetoend	dom-selection-collapsetoend
selectallchildren	dom-selection-selectallchildren
deletefromdocument	dom-selection-deletefromdocument
rangecount	dom-selection-rangecount
getrangeat	dom-selection-getrangeat
addrange	dom-selection-addrange
removerange	dom-selection-removerange
removeallranges	dom-selection-removeallranges
stringify0	dom-selection-tostring
textFieldSelection	textFieldSelection
select2	dom-textarea/input-select
selectionstart	dom-textarea/input-selectionstart
selectionend	dom-textarea/input-selectionend
setselectionrange	dom-textarea/input-setselectionrange
contenteditable	contenteditable
contenteditable0	attr-contenteditable
editable0	editable
contenteditable1	dom-contenteditable
iscontenteditable	dom-iscontenteditable
editing0	editing-host
caret	caret-position
user-editing	user-editing-actions
contenteditable-insertText	contenteditable-insertText
contenteditable-breakBlock	contenteditable-breakBlock
contenteditable-br	contenteditable-br
contenteditable-delete	contenteditable-delete
contenteditable-wrapSemantic	contenteditable-wrapSemantic
making	making-entire-documents-editable
designMode	designMode
dnd	dnd
drag-and	
introduction4	introduction-4
the-dragevent	the-dragevent-and-datatransfer-interfaces
dragevent	dragevent
initdragevent	dom-dragevent-initdragevent
initdrageventns	dom-dragevent-initdrageventns
datatransfer	dom-dragevent-datatransfer
datatransfer0	datatransfer
dropeffect	dom-datatransfer-dropeffect
effectallowed	dom-datatransfer-effectallowed
cleardata	dom-datatransfer-cleardata
setdata	dom-datatransfer-setdata
getdata	dom-datatransfer-getdata
types	dom-datatransfer-types
setdragimage	dom-datatransfer-setdragimage
addelement	dom-datatransfer-addelement
events1	events-fired-during-a-drag-and-drop-action
dragstart	event-dragstart
drag	event-drag
dragenter	event-dragenter
dragleave	event-dragleave
dragover	event-dragover
drop	event-drop
dragend	event-dragend
effectAllowed-initialization	effectAllowed-initialization
dropEffect-initialization	dropEffect-initialization
drag-and-drop	drag-and-drop-processing-model
source2	source-node
base-dnd-feedback	base-dnd-feedback
immediate	immediate-user-selection
current2	current-target-element
current3	current-drag-operation
when-the	when-the-drag-and-drop-operation-starts-or-ends-in-another-document
when-the0	when-the-drag-and-drop-operation-starts-or-ends-in-another-application
the-draggable	the-draggable-attribute
draggable	
draggable0	dom-draggable
copy-and	copy-and-paste
copy-to	copy-to-clipboard
cut-to	cut-to-clipboard
paste	paste-from-clipboard
paste0	paste-from-selection
security8	security-risks-in-the-drag-and-drop-model
undo	undo
undo-history	
undo-transaction	undo-transaction-history
dom-changes	dom-changes
undo-object	undo-object
the-undomanager	the-undomanager-interface
undomanager	undomanager
undomanager0	dom-undomanager
length13	dom-undomanager-length
itemn	dom-undomanager-item
current4	undo-position
position0	dom-undomanager-position
adddata	dom-undomanager-add
remove3	dom-undomanager-remove
clearundo	dom-undomanager-clearundo
clearredo	dom-undomanager-clearredo
undo-moving	undo:-moving-back-in-the-undo-transaction-history
undo-moving0	
redo-moving	redo:-moving-forward-in-the-undo-transaction-history
redo-moving0	
the-undomanagerevent	the-undomanagerevent-interface-and-the-undo-and-redo-events
undomanagerevent	undomanagerevent
initundomanagerevent	dom-undomanagerevent-initundomanagerevent
initundomanagereventns	initundomanagereventns()
data3	dom-undomanagerevent-data
undo0	event-undo
redo	event-redo
implementation0	implementation-notes
command	command-apis
execCommand	execCommand
ready	ready-for-editing-host-commands
querycommandenabled	dom-document-querycommandenabled
querycommandindeterm	dom-document-querycommandindeterm
querycommandstate	dom-document-querycommandstate
querycommandsupported	dom-document-querycommandsupported
querycommandvalue	dom-document-querycommandvalue
bold	command-bold
createlink	command-createlink
delete0	command-delete
formatblock	command-formatblock
forwarddelete	command-forwarddelete
insertimage	command-insertimage
inserthtml	command-inserthtml
insertlinebreak	command-insertlinebreak
insertorderedlist	command-insertorderedlist
insertunorderedlist	command-insertunorderedlist
insertparagraph	command-insertparagraph
inserttext	command-inserttext
italic	command-italic
redo0	command-redo
selectall0	command-selectall
subscript	command-subscript
superscript	command-superscript
undo1	command-undo
unlink	command-unlink
unselect	command-unselect
comms	comms
event3	event-definitions
message2	event-message
messageevent	messageevent
initmessageevent	dom-messageevent-initmessageevent
initmessageeventns	dom-messageevent-initmessageeventns
data4	dom-messageevent-data
origin1	dom-messageevent-origin
lasteventid	dom-messageevent-lasteventid
source3	dom-messageevent-source
messageport	dom-messageevent-messageport
posted	posted-message-task-source
server-sent-events	server-sent-events
server-sent	
the-remoteeventtarget	the-remoteeventtarget-interface
remoteeventtarget	remoteeventtarget
addeventsource	dom-remoteeventtarget-addeventsource
removeeventsource	dom-remoteeventtarget-removeeventsource
connecting	connecting-to-an-event-stream
list-of3	concept-eventsource-list
reconnection	concept-event-stream-reconnection-time
last-event	concept-event-stream-last-event-id
parsing2	parsing-an-event-stream
event-stream-interpretation	event-stream-interpretation
processField	processField
process	
dispatchMessage	dispatchMessage
dispatch	
remote	remote-event-task-source
notes	notes
network	network
web-sockets	
network-intro	network-intro
the-websocket	the-websocket-interface
websocket0	websocket
websocket1	dom-websocket
url4	dom-websocket-url
readystate1	dom-websocket-readystate
connecting0	dom-websocket-connecting
open3	dom-websocket-open
closed	dom-websocket-closed
postmessage	dom-websocket-postmessage
disconnect	dom-websocket-disconnect
websocket	websocket-events
open4	event-websocket-open
close1	event-websocket-close
onopen	handler-websocket-onopen
onmessage0	handler-websocket-onmessage
onclosed	handler-websocket-onclosed
the-web	the-web-socket-protocol
web-socket	web-socket-task-source
client-side	client-side-requirements
handshake	handshake
establish	establish-a-web-socket-connection
ws-ua-1	ws-ua-1
ws-ua-header-loop	ws-ua-header-loop
ws-ua-headers-processing	ws-ua-headers-processing
web-socket0	web-socket-connection-is-established
fail-the	fail-the-web-socket-connection
data-framing	data-framing
ws-cd-length	ws-cd-length
ws-cd-data	ws-cd-data
send-	send-data-using-the-web-socket
server-side	server-side-requirements
minimal	minimal-handshake
handshake0	handshake-details
ws-sd-framing	ws-sd-framing
ws-sd-data	ws-sd-data
closing0	closing-the-connection
close2	close-the-web-socket-connection
web-socket1	web-socket-connection-is-closed
closeWebSocket	closeWebSocket
crossDocumentMessages	crossDocumentMessages
cross-document	
introduction5	introduction-5
security9	security-4
authors	authors
user-agents	user-agents
posting	posting-text
postmessage0	dom-window-postmessage-2
posting0	posting-message-ports
postmessage1	dom-window-postmessage-3
posting1	posting-structured-data
channel	channel-messaging
channel0	
introduction6	introduction-6
message	message-channels
messagechannel	messagechannel
messagechannel0	dom-messagechannel
port1	dom-channel-port1
port2	dom-channel-port2
message0	message-ports
messageport0	messageport
port-message	port-message-queue
create	create-a-new-messageport-object
entangle	entangle
clone	clone-a-port
active0	dom-messageport-active
postmessage2	dom-messageport-postmessage
startconversation	dom-messageport-startconversation
start6	dom-messageport-start
available	port-owner-available
close3	dom-messageport-close
onmessage1	handler-messageport-onmessage
onclose	handler-messageport-onclose
ports	ports-and-browsing-contexts
ports0	ports-and-garbage-collection
syntax	syntax
writing0	writing-html-documents
the-doctype	the-doctype
doctype5	syntax-doctype
doctype6	doctype-legacy-string
elements1	elements-0
elements5	syntax-elements
void-elements	void-elements
tags	syntax-tags
tag-name0	syntax-tag-name
start	start-tags
start7	syntax-start-tags
end-tags	end-tags
end-tags0	syntax-end-tags
attributes3	attributes
attributes6	syntax-attributes
attribute3	syntax-attribute-name
attribute4	syntax-attribute-value
optional	optional-tags
omitted	syntax-tag-omission
x	x
x	x
x	x
x	x
element-restrictions	element-restrictions
cdata-rcdata-restrictions	cdata-rcdata-restrictions
escaping	syntax-escape
escaping0	syntax-escape-start
escaping1	syntax-escape-end
text0	text-0
text4	syntax-text
newlines	newlines
newlines0	syntax-newlines
character0	character-references
character6	syntax-charref
ambiguous	syntax-ambiguous-ampersand
cdata	cdata-sections
cdata1	syntax-cdata
comments	comments
comments0	syntax-comments
parsing	parsing
html-0	html-parser
parse8	parse-error
overview	overview-of-the-parsing-model
nestedParsing	nestedParsing
the-input0	the-input-stream
input1	
determining	determining-the-character-encoding
documentEncoding	documentEncoding
encoding0	encoding-sniffing-algorithm
confidence	concept-encoding-confidence
get-an	concept-get-attributes-when-sniffing
character1	character-encoding-requirements
preprocessing	preprocessing-the-input-stream
next-input	next-input-character
consumed	consumed
insertion	insertion-point
explicit0	explicit-eof-character
changing	changing-the-encoding-while-parsing
change	change-the-encoding
parse	parse-state
the-insertion	the-insertion-mode
using10	using-the-rules-for
original	original-insertion-mode
secondary1	secondary-insertion-mode
reset6	reset-the-insertion-mode-appropriately
the-stack	the-stack-of-open-elements
stack	stack-of-open-elements
current5	current-node
current6	current-table
special	special
scoping	scoping
formatting	formatting
phrasing1	phrasing
have-an	has-an-element-in-scope
have-an0	has-an-element-in-table-scope
the-list	the-list-of-active-formatting-elements
list-of4	list-of-active-formatting-elements
reconstruct	reconstruct-the-active-formatting-elements
clear1	clear-the-list-of-active-formatting-elements-up-to-the-last-marker
the-element	the-element-pointers
head-element	head-element-pointer
form-element	form-element-pointer
the-scripting	the-scripting-state
scripting3	scripting-flag
tokenization	tokenization
tokenization0	
content4	content-model-flag
escape	escape-flag
acknowledged	acknowledge-self-closing-flag
data-state	data-state
data-state0	
character2	character-reference-data-state
character7	
tag-open	tag-open-state
tag-open0	
close	close-tag-open-state
close4	
tag-name	tag-name-state
tag-name1	
before	before-attribute-name-state
before4	
attribute	attribute-name-state
attribute5	
after	after-attribute-name-state
after4	
before0	before-attribute-value-state
before5	
attribute0	attribute-value-(double-quoted)-state
attribute6	
attribute1	attribute-value-(single-quoted)-state
attribute7	
attribute2	attribute-value-(unquoted)-state
attribute8	
character3	character-reference-in-attribute-value-state
character8	
after0	after-attribute-value-(quoted)-state
after5	
self-closing	self-closing-start-tag-state
self-closing0	
bogus	bogus-comment-state
bogus1	
markup	markup-declaration-open-state
markup0	
comment0	comment-start-state
comment5	
comment1	comment-start-dash-state
comment6	
comment2	comment-state
comment	comment
comment3	comment-end-dash-state
comment7	
comment4	comment-end-state
comment8	
doctype	doctype-state
doctype7	
before1	before-doctype-name-state
before6	
doctype0	doctype-name-state
doctype8	
after1	after-doctype-name-state
after6	
before2	before-doctype-public-identifier-state
before7	
doctype1	doctype-public-identifier-(double-quoted)-state
doctype9	
doctype2	doctype-public-identifier-(single-quoted)-state
doctype10	
after2	after-doctype-public-identifier-state
after7	
before3	before-doctype-system-identifier-state
before8	
doctype3	doctype-system-identifier-(double-quoted)-state
doctype11	
doctype4	doctype-system-identifier-(single-quoted)-state
doctype12	
after3	after-doctype-system-identifier-state
after8	
bogus0	bogus-doctype-state
bogus2	
cdata0	cdata-section-state
cdata2	
tokenizing	tokenizing-character-references
consume	consume-a-character-reference
additional	additional-allowed-character
tree-construction	tree-construction
tree-construction0	
insert	insert-a-character
mutation-during-parsing	mutation-during-parsing
creating	creating-and-inserting-elements
create0	create-an-element-for-the-token
insert0	insert-an-html-element
insert1	insert-a-foreign-element
adjust	adjust-mathml-attributes
adjust0	adjust-foreign-attributes
generic0	generic-cdata-element-parsing-algorithm
generic1	generic-rcdata-element-parsing-algorithm
closing1	closing-elements-that-have-implied-end-tags
generate	generate-implied-end-tags
foster	foster-parenting
foster0	foster-parent
tainted	tainted
foster1	foster-parent-element
the-initial	the-initial-insertion-mode
initial	
quirks-mode-doctypes	quirks-mode-doctypes
the-before	the-before-html-insertion-mode
before9	
parser-appcache	parser-appcache
the-before0	the-before-head-insertion-mode
before10	
parsing-main-inhead	parsing-main-inhead
in-head	
meta-charset-during-parse	meta-charset-during-parse
scriptTag	scriptTag
180157&amp;action=view	180157&amp;action=view
parsing-main-inheadnoscript	parsing-main-inheadnoscript
in-head0	
the-after	the-after-head-insertion-mode
after9	
parsing-main-inbody	parsing-main-inbody
in-body	
adoptionAgency	adoptionAgency
isindex	isindex
parsing-main-incdata	parsing-main-incdata
in-cdatarcdata	
scriptTagParserResumes	scriptTagParserResumes
parsing-main-intable	parsing-main-intable
in-table	
clear2	clear-the-stack-back-to-a-table-context
parsing-main-incaption	parsing-main-incaption
in-caption	
parsing-main-incolgroup	parsing-main-incolgroup
in-column	
parsing-main-intbody	parsing-main-intbody
in-table0	
clear3	clear-the-stack-back-to-a-table-body-context
parsing-main-intr	parsing-main-intr
in-row	
clear4	clear-the-stack-back-to-a-table-row-context
parsing-main-intd	parsing-main-intd
in-cell	
close5	close-the-cell
parsing-main-inselect	parsing-main-inselect
in-select	
parsing-main-inselectintable	parsing-main-inselectintable
in-select0	
parsing-main-inforeign	parsing-main-inforeign
in-foreign	
parsing-main-afterbody	parsing-main-afterbody
after10	
parsing-main-inframeset	parsing-main-inframeset
in-frameset	
parsing-main-afterframeset	parsing-main-afterframeset
after11	
the-after0	the-after-after-body-insertion-mode
after12	
the-after1	the-after-after-frameset-insertion-mode
after13	
the-end	the-end
stops	stop-parsing
delays	delay-the-load-event
coercing	coercing-an-html-dom-into-an-infoset
namespaces	namespaces
html-namespace0	html-namespace-0
mathml0	mathml-namespace
svg-namespace	svg-namespace
xlink	xlink-namespace
xml-namespace	xml-namespace
xmlns	xmlns-namespace
serializing	serializing-html-fragments
html-fragment	html-fragment-serialization-algorithm
escapingString	escapingString
parsing3	parsing-html-fragments
html-fragment0	html-fragment-parsing-algorithm
fragment	fragment-case
named	named-character-references
named0	
rendering	rendering
datagridPseudos	datagridPseudos
sizing	sizing-of-embedded-content
obtain	obtain-a-physical-form
rendering0	rendering-and-the-dom
mediamodeabstractview	mediamodeabstractview
mediamode	mediamode
rendering1	rendering-and-menus/toolbars
the-icon	the-'icon'-property
obsolete	obsolete-elements,-attributes,-and-apis
the-body0	the-body-element-0
fgcolor	dom-document-fgcolor
bgcolor	dom-document-bgcolor
linkcolor	dom-document-linkcolor
vlinkcolor	dom-document-vlinkcolor
alinkcolor	dom-document-alinkcolor
text5	dom-body-text
bgcolor0	dom-body-bgcolor
background0	dom-body-background
link0	dom-body-link
alink	dom-body-alink
vlink	dom-body-vlink
the-applet	the-applet-element
applet	
sandboxPluginApplet	sandboxPluginApplet
applets	dom-document-applets
no	no
localization	localization
declarative	declarative-2d-vector-graphics-and-animation
declarative0	declarative-3d-scenes
timers	timers
windowtimers	windowtimers
timeouthandler	timeouthandler
settimeout	dom-windowtimers-settimeout
settimeout0	
setinterval...	dom-windowtimers-setinterval
cleartimeout	dom-windowtimers-cleartimeout
clearinterval	dom-windowtimers-clearinterval
index	index
references	references
acknowledgements	acknowledgements
dday	dday
